34 34 34 34 34 34 34 34 34 34 34 34 34 34 34 34 34 34 34 34 34 34 34 34 34 34 34 34 34 34 34 34 34 34 34 34 34 34 34 34 34 34 34 34 34 34 34 34 34 34
34 34 34 34 34 34 34 34 34 34 34 34 34 34 34 34 34 34 34 34 34 34 34 34 34 34 34 34 34 34 34 34 34 34 34 34 34 34 34 34 34 34 34 34 34 34 34 34 34 34
34 34 34 34 34 34 34 34 34 34 34 34 34 34 34 34 34 34 34 34 34 34 34 34 34 34 34 34 34 34 34 34 34 34 34 34 34 34 34 34 34 34 34 34 34 34 34 34 34 34
34 34 34 34 34 34 34 34 34 34 34 34 34 34 34 34 34 34 34 34 34 34 34 34 34 34 34 34 34 34 34 34 34 34 34 34 34 34 34 34 34 34 34 34 34 34 34 34 34 34
34 34 34 34 34 34 34 34 34 34 34 34 34 34 34 34 34 34 34 34 34 34 34 34 34 34 34 34 34 34 34 34 34 34 34 34 34 34 34 34 34 34 34 34 34 34 34 34 34 34
34 34 34 34 34 34 34 34 34 34 34 34 34 34 34 34 34 34 34 34 34 34 34 34 34 34 34 34 34 34 34 34 34 34 34 34 34 34 34 34 34 34 34 34 34 34 34 34 34 34
34 34 34 34 34 34 34 34 34 34 34 34 34 34 34 34 34 34 34 34 34 34 34 34 34 34 34 34 34 34 34 34 34 34 34 34 34 34 34 34 34 34 34 34 34 34 34 34 34 34
34 34 34 34 34 34 34 34 34 34 34 34 34 34 34 34 34 34 34 34 34 34 34 34 34 34 34 34 34 34 34 34 34 34 34 34 34 34 34 34 34 34 34 34 34 34 34 34 34 34
34 34 34 34 34 34 34 34 34 34 34 34 34 34 34 34 34 34 34 34 34 34 34 34 34 34 34 34 34 34 34 34 34 34 34 34 34 34 34 34 34 34 34 34 34 34 34 34 34 34
34 34 34 34 34 34 34 34 34 34 9 9 9 9 9 9 9 9 9 9 9 9 9 9 9 9 9 9 9 9 9 9 9 9 9 9 9 9 9 9 34 34 34 34 34 34 34 34 34 34 34 34 34 34 34 34 34 34 34 34
34 34 34 34 34 34 34 34 34 34 9 14 20 16 11 18 12 17 21 14 10 19 12 18 9 14 17 15 20 13 18 11 21 19 17 14 12 16 20 9 34 34 34 34 34 34 34 34 34 34
34 34 34 34 34 34 34 34 34 34 9 18 19 19 15 17 14 13 20 18 11 14 16 21 9 20 18 11 15 12 19 17 14 21 16 13 18 15 17 9 34 34 34 34 34 34 34 34 34 34
34 34 34 34 34 34 34 34 34 34 9 16 11 20 14 18 17 12 19 16 15 21 13 10 9 19 12 14 20 18 16 11 17 15 18 20 12 19 14 9 34 34 34 34 34 34 34 34 34 34
34 34 34 34 34 34 34 34 34 34 9 15 17 13 19 14 11 20 18 17 12 15 21 16 12 14 19 20 17 15 11 18 16 14 21 17 13 19 12 9 34 34 34 34 34 34 34 34 34 34
34 34 34 34 34 34 34 34 34 34 9 18 14 12 16 21 19 11 13 17 20 18 14 12 12 17 12 14 11 21 19 15 17 20 10 18 21 14 16 9 34 34 34 34 34 34 34 34 34 34
34 34 34 34 34 34 34 34 34 34 9 17 20 15 12 18 11 21 16 14 17 19 13 20 12 18 21 11 17 12 14 19 10 18 17 20 14 12 15 9 34 34 34 34 34 34 34 34 34 34
34 34 34 34 34 34 34 34 34 34 9 19 13 17 12 11 14 18 12 16 21 10 17 11 9 16 19 20 18 14 21 12 11 17 20 13 15 18 12 9 34 34 34 34 34 34 34 34 34 34
34 34 34 34 34 34 34 34 34 34 9 12 18 14 17 20 13 15 11 18 16 17 14 20 9 11 18 14 12 16 13 21 17 14 19 18 20 11 15 9 34 34 34 34 34 34 34 34 34 34
34 34 34 34 34 34 34 34 34 34 9 16 14 18 11 12 20 17 14 19 13 20 18 12 9 13 20 17 19 11 14 18 16 12 21 10 17 14 18 9 34 34 34 34 34 34 34 34 34 34
34 34 34 34 34 34 34 34 34 34 9 14 19 17 20 13 12 18 14 15 17 11 19 16 9 20 17 15 12 18 21 14 19 11 16 21 13 12 20 9 34 34 34 34 34 34 34 34 34 34
34 34 34 34 34 34 34 34 34 34 9 20 17 11 18 16 14 12 19 21 13 18 10 19 9 17 14 12 20 18 15 17 12 21 14 19 18 16 11 9 34 34 34 34 34 34 34 34 34 34
34 34 34 34 34 34 34 34 34 34 9 18 12 14 21 15 17 20 11 14 19 12 18 16 9 21 10 17 14 19 20 16 15 18 11 21 12 10 19 9 34 34 34 34 34 34 34 34 34 34
34 34 34 34 34 34 34 34 34 34 9 14 16 11 18 19 20 14 21 12 17 11 16 10 9 18 21 19 17 14 15 12 18 20 14 17 13 21 10 9 34 34 34 34 34 34 34 34 34 34
34 34 34 34 34 34 34 34 34 34 9 9 9 9 9 9 12 12 12 9 9 9 9 9 9 9 9 9 9 9 12 12 12 9 9 9 9 9 9 9 34 34 34 34 34 34 34 34 34 34 34 34 34 34 34 34 34
34 34 34 34 34 34 34 34 34 34 9 20 14 17 12 18 21 15 11 20 16 14 12 17 9 11 14 20 18 13 16 12 14 18 21 11 20 17 15 9 34 34 34 34 34 34 34 34 34 34
34 34 34 34 34 34 34 34 34 34 9 17 12 21 18 14 19 10 20 12 17 18 14 11 9 20 18 15 11 17 14 21 18 12 16 19 14 10 18 9 34 34 34 34 34 34 34 34 34 34
34 34 34 34 34 34 34 34 34 34 9 14 18 13 17 21 11 16 19 14 12 20 18 15 9 18 12 16 21 11 19 17 20 14 11 13 18 21 14 9 34 34 34 34 34 34 34 34 34 34
34 34 34 34 34 34 34 34 34 34 9 19 12 17 10 18 21 14 15 20 19 14 11 17 9 12 21 18 14 20 10 18 16 21 14 19 17 12 15 9 34 34 34 34 34 34 34 34 34 34
34 34 34 34 34 34 34 34 34 34 9 16 11 14 20 17 18 12 21 14 14 19 17 19 9 20 14 19 12 18 11 16 21 14 19 12 18 17 20 9 34 34 34 34 34 34 34 34 34 34
34 34 34 34 34 34 34 34 34 34 9 12 20 11 17 14 18 21 16 13 12 17 14 30 9 12 17 14 20 13 21 19 11 16 18 14 10 20 17 9 34 34 34 34 34 34 34 34 34 34
34 34 34 34 34 34 34 34 34 34 9 18 14 20 17 13 21 19 14 11 19 12 20 17 9 21 14 12 18 17 11 15 21 12 20 16 18 19 14 9 34 34 34 34 34 34 34 34 34 34
34 34 34 34 34 34 34 34 34 34 9 21 17 12 18 10 19 14 13 21 17 20 14 18 12 17 12 20 14 18 16 14 17 21 11 20 13 12 18 9 34 34 34 34 34 34 34 34 34 34
34 34 34 34 34 34 34 34 34 34 9 17 14 18 11 20 16 12 21 14 18 17 20 11 12 19 17 14 12 21 11 19 17 14 20 12 21 18 16 9 34 34 34 34 34 34 34 34 34 34
34 34 34 34 34 34 34 34 34 34 9 14 12 20 18 11 17 21 19 14 20 13 12 17 12 20 18 21 14 17 12 18 14 20 11 16 12 19 21 9 34 34 34 34 34 34 34 34 34 34
34 34 34 34 34 34 34 34 34 34 9 13 18 14 17 19 12 14 21 11 18 17 14 10 9 14 21 18 16 12 20 11 14 17 18 19 20 14 16 9 34 34 34 34 34 34 34 34 34 34
34 34 34 34 34 34 34 34 34 34 9 18 12 17 15 20 14 16 11 18 21 14 19 12 9 17 14 12 21 16 19 14 17 20 13 11 18 21 14 9 34 34 34 34 34 34 34 34 34 34
34 34 34 34 34 34 34 34 34 34 9 14 19 11 16 18 12 20 14 17 12 10 21 16 9 18 21 14 19 17 12 14 18 21 11 20 17 14 15 9 34 34 34 34 34 34 34 34 34 34
34 34 34 34 34 34 34 34 34 34 9 12 18 21 14 17 11 14 20 18 16 17 14 13 9 21 17 12 14 20 18 11 19 17 14 18 12 21 16 9 34 34 34 34 34 34 34 34 34 34
34 34 34 34 34 34 34 34 34 34 9 9 9 9 9 9 9 9 9 9 9 9 9 9 9 9 9 9 9 9 9 9 9 9 9 9 9 9 9 9 34 34 34 34 34 34 34 34 34 34 34 34 34 34 34 34 34 34 34
34 34 34 34 34 34 34 34 34 34 34 34 34 34 34 34 34 34 34 34 34 34 34 34 34 34 34 34 34 34 34 34 34 34 34 34 34 34 34 34 34 34 34 34 34 34 34 34 34 34
34 34 34 34 34 34 34 34 34 34 34 34 34 34 34 34 34 34 34 34 34 34 34 34 34 34 34 34 34 34 34 34 34 34 34 34 34 34 34 34 34 34 34 34 34 34 34 34 34 34
34 34 34 34 34 34 34 34 34 34 34 34 34 34 34 34 34 34 34 34 34 34 34 34 34 34 34 34 34 34 34 34 34 34 34 34 34 34 34 34 34 34 34 34 34 34 34 34 34 34
34 34 34 34 34 34 34 34 34 34 34 34 34 34 34 34 34 34 34 34 34 34 34 34 34 34 34 34 34 34 34 34 34 34 34 34 34 34 34 34 34 34 34 34 34 34 34 34 34 34
34 34 34 34 34 34 34 34 34 34 34 34 34 34 34 34 34 34 34 34 34 34 34 34 34 34 34 34 34 34 34 34 34 34 34 34 34 34 34 34 34 34 34 34 34 34 34 34 34 34
34 34 34 34 34 34 34 34 34 34 34 34 34 34 34 34 34 34 34 34 34 34 34 34 34 34 34 34 34 34 34 34 34 34 34 34 34 34 34 34 34 34 34 34 34 34 34 34 34 34
34 34 34 34 34 34 34 34 34 34 34 34 34 34 34 34 34 34 34 34 34 34 34 34 34 34 34 34 34 34 34 34 34 34 34 34 34 34 34 34 34 34 34 34 34 34 34 34 34 34
34 34 34 34 34 34 34 34 34 34 34 34 34 34 34 34 34 34 34 34 34 34 34 34 34 34 34 34 34 34 34 34 34 34 34 34 34 34 34 34 34 34 34 34 34 34 34 34 34 34
34 34 34 34 34 34 34 34 34 34 34 34 34 34 34 34 34 34 34 34 34 34 34 34 34 34 34 34 34 34 34 34 34 34 34 34 34 34 34 34 34 34 34 34 34 34 34 34 34 34
34 34 34 34 34 34 34 34 34 34 34 34 34 34 34 34 34 34 34 34 34 34 34 34 34 34 34 34 34 34 34 34 34 34 34 34 34 34 34 34 34 34 34 34 34 34 34 34 34 34
34 34 34 34 34 34 34 34 34 34 34 34 34 34 34 34 34 34 34 34 34 34 34 34 34 34 34 34 34 34 34 34 34 34 34 34 34 34 34 34 34 34 34 34 34 34 34 34 34 34
