8 8 8 8 8 8 8 8 8 8 8 8 8 8 8 8 8 8 8 8 8 8 8 8 8 8 8 8 8 8 8 8 8 8 8 8 8 8 8 8 8 8 8 8 8 8 8 8 8 8
8 8 8 8 8 8 8 8 8 8 8 8 8 8 8 8 8 8 8 8 8 8 8 8 8 8 8 8 8 8 8 8 8 8 8 8 8 8 8 8 8 8 8 8 8 8 8 8 8 8
8 8 8 8 8 8 8 8 8 8 8 8 8 8 8 8 8 8 8 8 8 8 8 8 8 8 8 8 8 8 8 8 8 8 8 8 8 8 8 8 8 8 8 8 8 8 8 8 8 8
8 8 8 8 8 8 8 8 8 8 8 8 8 8 8 8 8 8 8 8 8 8 8 8 8 8 8 8 8 8 8 8 8 8 8 8 8 8 8 8 8 8 8 8 8 8 8 8 8 8
8 8 8 8 8 8 8 8 8 8 8 8 8 8 8 8 8 8 8 8 8 8 8 8 8 8 8 8 8 8 8 8 8 8 8 8 8 8 8 8 8 8 8 8 8 8 8 8 8 8
8 8 8 8 8 8 8 8 8 8 8 8 8 8 8 8 8 8 8 8 8 8 8 8 8 8 8 8 8 8 8 8 8 8 8 8 8 8 8 8 8 8 8 8 8 8 8 8 8 8
8 8 8 8 8 8 8 8 8 8 8 8 8 8 8 8 8 8 8 8 8 8 8 8 8 8 8 8 8 8 8 8 8 8 8 8 8 8 8 8 8 8 8 8 8 8 8 8 8 8
8 8 8 8 8 8 8 8 8 8 8 8 8 8 8 8 8 8 8 8 8 8 8 8 8 8 8 8 8 8 8 8 8 8 8 8 8 8 8 8 8 8 8 8 8 8 8 8 8 8
8 8 8 8 8 8 8 8 8 8 8 8 8 8 8 8 8 8 8 8 8 8 8 8 8 8 8 8 8 8 8 8 8 8 8 8 8 8 8 8 8 8 8 8 8 8 8 8 8 8
8 8 8 8 8 8 8 8 8 8 22 22 22 22 22 22 22 22 22 22 22 22 22 22 22 22 22 22 22 22 22 22 22 22 22 22 22 22 22 22 8 8 8 8 8 8 8 8 8 8
8 8 8 8 8 8 8 8 8 8 22 6 7 6 7 6 7 6 8 8 8 8 6 7 6 7 6 7 6 8 8 8 8 6 7 6 7 6 7 22 8 8 8 8 8 8 8 8 8 8
8 8 8 8 8 8 8 8 8 8 22 7 6 7 6 7 6 7 8 8 8 8 7 6 7 6 7 6 7 8 8 8 8 7 6 7 6 7 6 22 8 8 8 8 8 8 8 8 8 8
8 8 8 8 8 8 8 8 8 8 22 6 7 6 7 6 7 6 7 6 7 6 7 6 7 6 7 6 7 6 7 6 7 6 7 6 7 6 7 22 8 8 8 8 8 8 8 8 8 8
8 8 8 8 8 8 8 8 8 8 22 7 6 7 6 7 6 7 8 8 8 8 7 6 7 6 7 6 7 8 8 8 8 7 6 7 6 7 6 22 8 8 8 8 8 8 8 8 8 8
8 8 8 8 8 8 8 8 8 8 22 6 7 6 7 6 7 6 8 8 8 8 6 7 6 7 6 7 6 8 8 8 8 6 7 6 7 6 7 22 8 8 8 8 8 8 8 8 8 8
8 8 8 8 8 8 8 8 8 8 22 7 6 7 6 7 6 7 6 7 6 7 6 7 6 7 6 7 6 7 6 7 6 7 6 7 6 7 6 22 8 8 8 8 8 8 8 8 8 8
8 8 8 8 8 8 8 8 8 8 22 6 7 6 7 6 7 6 8 8 8 8 6 7 6 7 6 7 6 8 8 8 8 6 7 6 7 6 7 22 8 8 8 8 8 8 8 8 8 8
8 8 8 8 8 8 8 8 8 8 22 7 6 7 6 7 6 7 8 8 8 8 7 6 7 6 7 6 7 8 8 8 8 7 6 7 6 7 6 22 8 8 8 8 8 8 8 8 8 8
8 8 8 8 8 8 8 8 8 8 22 6 7 6 7 6 7 6 7 6 7 6 7 6 7 6 7 6 7 6 7 6 7 6 7 6 7 6 7 22 8 8 8 8 8 8 8 8 8 8
8 8 8 8 8 8 8 8 8 8 22 7 6 7 6 7 6 7 8 8 8 8 7 6 7 6 7 6 7 8 8 8 8 7 6 7 6 7 6 22 8 8 8 8 8 8 8 8 8 8
8 8 8 8 8 8 8 8 8 8 22 6 7 6 7 6 7 6 8 8 8 8 6 7 6 7 6 7 6 8 8 8 8 6 7 6 7 6 7 22 8 8 8 8 8 8 8 8 8 8
8 8 8 8 8 8 8 8 8 8 22 7 6 7 6 7 6 7 6 7 6 7 6 7 6 7 6 7 6 7 6 7 6 7 6 7 6 7 6 22 8 8 8 8 8 8 8 8 8 8
8 8 8 8 8 8 8 8 8 8 22 6 7 6 7 6 7 6 8 8 8 8 6 7 6 7 6 7 6 8 8 8 8 6 7 6 7 6 7 22 8 8 8 8 8 8 8 8 8 8
8 8 8 8 8 8 8 8 8 8 22 7 6 7 6 7 6 7 8 8 8 8 7 6 7 6 7 6 7 8 8 8 8 7 6 7 6 7 6 22 8 8 8 8 8 8 8 8 8 8
8 8 8 8 8 8 8 8 8 8 22 6 7 6 7 6 7 6 7 6 7 6 7 6 7 6 7 6 7 6 7 6 7 6 7 6 7 6 7 22 8 8 8 8 8 8 8 8 8 8
8 8 8 8 8 8 8 8 8 8 22 7 6 7 6 7 6 7 8 8 8 8 7 6 7 6 7 6 7 8 8 8 8 7 6 7 6 7 6 22 8 8 8 8 8 8 8 8 8 8
8 8 8 8 8 8 8 8 8 8 22 6 7 6 7 6 7 6 8 8 8 8 6 7 6 7 6 7 6 8 8 8 8 6 7 6 7 6 7 22 8 8 8 8 8 8 8 8 8 8
8 8 8 8 8 8 8 8 8 8 22 7 6 7 6 7 6 7 6 7 6 7 6 7 6 7 6 7 6 7 6 7 6 7 6 7 6 7 6 22 8 8 8 8 8 8 8 8 8 8
8 8 8 8 8 8 8 8 8 8 22 6 7 6 7 6 7 6 8 8 8 8 6 7 6 7 6 7 6 8 8 8 8 6 7 6 7 6 7 22 8 8 8 8 8 8 8 8 8 8
8 8 8 8 8 8 8 8 8 8 22 7 6 7 6 7 6 7 8 8 8 8 7 6 7 6 7 6 7 8 8 8 8 7 6 7 6 7 6 22 8 8 8 8 8 8 8 8 8 8
8 8 8 8 8 8 8 8 8 8 22 6 7 6 7 6 7 6 7 6 7 6 7 6 7 6 7 6 7 6 7 6 7 6 7 6 7 6 7 22 8 8 8 8 8 8 8 8 8 8
8 8 8 8 8 8 8 8 8 8 22 7 6 7 6 7 6 7 8 8 8 8 7 6 7 6 7 6 7 8 8 8 8 7 6 7 6 7 6 22 8 8 8 8 8 8 8 8 8 8
8 8 8 8 8 8 8 8 8 8 22 6 7 6 7 6 7 6 8 8 8 8 6 7 6 7 6 7 6 8 8 8 8 6 7 6 7 6 7 22 8 8 8 8 8 8 8 8 8 8
8 8 8 8 8 8 8 8 8 8 22 7 6 7 6 7 6 7 6 7 6 7 6 7 6 7 6 7 6 7 6 7 6 7 6 7 6 7 6 22 8 8 8 8 8 8 8 8 8 8
8 8 8 8 8 8 8 8 8 8 22 6 7 6 7 6 7 6 8 8 8 8 6 7 6 7 6 7 6 8 8 8 8 6 7 6 7 6 7 22 8 8 8 8 8 8 8 8 8 8
8 8 8 8 8 8 8 8 8 8 22 6 7 6 7 6 7 6 8 8 8 8 6 7 6 7 6 7 6 8 8 8 8 6 7 6 7 6 7 22 8 8 8 8 8 8 8 8 8 8
8 8 8 8 8 8 8 8 8 8 22 6 7 6 7 6 7 6 8 8 8 8 6 7 6 7 6 7 6 8 8 8 8 6 7 6 7 6 7 22 8 8 8 8 8 8 8 8 8 8
8 8 8 8 8 8 8 8 8 8 22 6 7 6 7 6 7 6 8 8 8 8 6 7 6 7 6 7 6 8 8 8 8 6 7 6 7 6 7 22 8 8 8 8 8 8 8 8 8 8
8 8 8 8 8 8 8 8 8 8 22 22 22 22 22 22 22 22 22 22 22 22 22 22 22 22 22 22 22 22 22 22 22 22 22 22 22 22 22 22 8 8 8 8 8 8 8 8 8 8
8 8 8 8 8 8 8 8 8 8 8 8 8 8 8 8 8 8 8 8 8 8 8 8 8 8 8 8 8 8 8 8 8 8 8 8 8 8 8 8 8 8 8 8 8 8 8 8 8 8
8 8 8 8 8 8 8 8 8 8 8 8 8 8 8 8 8 8 8 8 8 8 8 8 8 8 8 8 8 8 8 8 8 8 8 8 8 8 8 8 8 8 8 8 8 8 8 8 8 8
8 8 8 8 8 8 8 8 8 8 8 8 8 8 8 8 8 8 8 8 8 8 8 8 8 8 8 8 8 8 8 8 8 8 8 8 8 8 8 8 8 8 8 8 8 8 8 8 8 8
8 8 8 8 8 8 8 8 8 8 8 8 8 8 8 8 8 8 8 8 8 8 8 8 8 8 8 8 8 8 8 8 8 8 8 8 8 8 8 8 8 8 8 8 8 8 8 8 8 8
8 8 8 8 8 8 8 8 8 8 8 8 8 8 8 8 8 8 8 8 8 8 8 8 8 8 8 8 8 8 8 8 8 8 8 8 8 8 8 8 8 8 8 8 8 8 8 8 8 8
8 8 8 8 8 8 8 8 8 8 8 8 8 8 8 8 8 8 8 8 8 8 8 8 8 8 8 8 8 8 8 8 8 8 8 8 8 8 8 8 8 8 8 8 8 8 8 8 8 8
8 8 8 8 8 8 8 8 8 8 8 8 8 8 8 8 8 8 8 8 8 8 8 8 8 8 8 8 8 8 8 8 8 8 8 8 8 8 8 8 8 8 8 8 8 8 8 8 8 8
8 8 8 8 8 8 8 8 8 8 8 8 8 8 8 8 8 8 8 8 8 8 8 8 8 8 8 8 8 8 8 8 8 8 8 8 8 8 8 8 8 8 8 8 8 8 8 8 8 8
8 8 8 8 8 8 8 8 8 8 8 8 8 8 8 8 8 8 8 8 8 8 8 8 8 8 8 8 8 8 8 8 8 8 8 8 8 8 8 8 8 8 8 8 8 8 8 8 8 8
8 8 8 8 8 8 8 8 8 8 8 8 8 8 8 8 8 8 8 8 8 8 8 8 8 8 8 8 8 8 8 8 8 8 8 8 8 8 8 8 8 8 8 8 8 8 8 8 8 8
