00000000000000
00222200000000
00222200000000
00000000000000
00000000000000
00000000000000
00000000000000
00000000000000
00000000000000
10000022220001
10000022220001
10000022220001
10000000000001
11111111111111
