1 1 1 1 1 1 1 1 1 1 1 1 1 1 1 1 1 1 1 1 1 1 1 1 1 1 1 1 1 1
1 3 3 3 3 3 4 3 1 1 3 3 3 3 3 3 3 3 3 3 3 3 3 3 3 4 3 3 3 1
1 3 3 3 3 3 3 3 1 1 3 3 3 3 5 5 5 5 3 3 3 4 4 3 3 3 3 3 3 1
1 3 3 3 3 4 3 2 2 2 2 2 2 3 5 3 0 5 0 3 3 4 4 3 3 4 3 3 3 1
1 3 0 5 5 5 3 2 2 2 2 2 2 5 5 3 0 5 0 3 4 3 3 3 3 3 4 3 3 1
1 3 0 5 0 3 3 2 2 2 2 2 2 3 3 3 0 5 0 3 3 2 2 4 3 4 3 3 3 1
1 3 0 5 0 3 3 2 2 2 2 2 2 3 3 3 0 5 0 3 3 2 2 4 3 3 3 3 3 1
1 3 0 5 0 3 3 3 1 1 3 3 3 3 3 3 0 5 0 3 3 4 3 3 4 3 3 3 3 1
1 3 0 5 0 3 3 3 1 1 3 3 3 3 3 3 0 5 0 3 3 3 3 3 3 3 3 3 3 1
1 4 0 5 0 3 3 3 1 1 3 3 3 3 3 3 0 5 0 3 4 4 4 4 4 4 4 4 4 1
1 0 0 5 0 0 0 0 0 0 0 0 0 0 0 0 0 5 0 0 0 0 0 0 0 0 0 0 0 1
1 7 5 5 5 5 5 5 5 5 5 5 5 5 5 5 5 5 5 5 5 5 5 5 5 5 5 5 5 1
1 0 0 0 0 0 0 0 0 0 0 0 0 0 0 0 0 5 0 0 0 0 0 0 0 0 0 0 0 1
1 3 3 3 3 3 3 3 1 1 3 3 3 3 3 3 0 5 0 3 4 4 4 4 4 4 4 4 4 1
1 3 3 3 3 4 3 3 1 1 3 3 3 3 3 3 0 5 0 3 3 3 3 3 3 3 4 3 3 1
1 3 4 3 4 3 3 3 1 1 3 4 3 4 3 3 0 5 0 3 3 3 3 3 4 3 4 3 3 1
1 3 4 3 3 4 3 3 1 1 3 3 3 3 3 3 0 5 0 3 3 3 3 4 4 3 3 3 3 1
1 3 3 4 4 3 3 3 1 1 4 3 3 3 4 3 0 5 0 3 3 3 3 3 3 3 3 4 3 1
1 3 3 4 3 3 3 3 1 1 3 4 4 4 3 3 0 5 0 3 3 3 3 4 4 3 3 3 3 1
1 3 3 3 3 3 3 3 1 1 3 3 3 3 3 3 0 5 0 3 3 3 3 3 3 3 3 3 3 1
1 3 3 3 3 3 3 3 1 1 3 3 3 3 3 3 0 5 0 3 3 3 3 3 3 3 3 3 3 1
1 3 3 3 3 3 3 3 3 3 3 3 3 3 3 3 3 3 3 3 3 3 3 3 3 3 3 3 3 1
2 2 2 2 2 2 2 2 2 2 2 2 2 2 2 2 2 2 2 2 2 2 2 2 2 2 2 2 2 2
2 2 2 2 2 2 2 2 2 2 2 2 2 2 2 2 2 2 2 2 2 2 2 2 2 2 2 2 2 2
2 2 2 2 2 2 2 2 2 2 2 2 2 2 2 2 2 2 2 2 2 2 2 2 2 2 2 2 2 2
2 2 2 2 2 2 2 2 2 2 2 2 2 2 2 2 2 2 2 2 2 2 2 2 2 2 2 2 2 2
2 2 2 2 2 2 2 2 2 2 2 2 2 2 2 2 2 2 2 2 2 2 2 2 2 2 2 2 2 2
2 2 2 2 2 2 2 2 2 2 2 2 2 2 2 2 2 2 2 2 2 2 2 2 2 2 2 2 2 2
2 2 2 2 2 2 2 2 2 2 2 2 2 2 2 2 2 2 2 2 2 2 2 2 2 2 2 2 2 2
2 2 2 2 2 2 2 2 2 2 2 2 2 2 2 2 2 2 2 2 2 2 2 2 2 2 2 2 2 2
