103 103 103 103 103 103 103 103 103 103 103 103 103 103 103 103 103 103 103 103 103 103 103 103 103 103 103 103 103 103 103 103 103 103 103 103 103 103 103 103 103 103 103 103 103 103 103 103 103 103 
103 103 103 103 103 103 103 103 103 103 103 103 103 103 103 103 103 103 103 103 103 103 103 103 103 103 103 103 103 103 103 103 103 103 103 103 103 103 103 103 103 103 103 103 103 103 103 103 103 103 
103 103 103 103 103 103 103 103 103 44 45 45 45 45 45 45 45 45 45 45 45 45 45 45 45 45 45 45 45 45 45 45 45 46 103 70 103 30 103 103 103 103 103 103 103 103 103 103 103 103 
103 103 103 103 103 103 103 103 103 54 55 55 55 55 55 55 55 55 55 55 55 55 55 55 55 55 55 55 55 55 55 55 55 56 103 115 101 115 27 28 28 28 28 28 28 28 28 28 28 28 
105 105 105 105 105 105 105 106 103 54 55 55 4 5 6 55 55 47 48 5 5 70 78 77 78 6 55 55 4 5 6 55 55 56 103 70 115 30 115 115 115 115 115 115 115 115 115 115 115 115 
125 125 125 125 125 125 125 126 103 54 55 55 14 121 16 55 55 57 58 25 25 70 58 57 58 26 55 55 14 113 16 55 55 56 103 115 101 115 27 28 28 28 28 28 28 28 28 28 28 28 
115 115 115 115 115 115 115 115 103 54 55 55 24 25 26 55 55 34 35 35 35 35 35 35 35 36 55 55 24 25 26 55 55 56 103 70 115 30 115 115 115 115 115 115 115 115 115 115 115 115 
105 105 105 105 105 105 105 106 103 54 55 55 34 35 36 55 55 55 55 55 55 55 55 55 55 55 55 55 34 35 36 55 55 56 103 115 101 115 27 28 28 28 28 28 28 28 28 28 28 28 
125 125 125 125 125 125 125 126 103 54 55 55 55 55 55 55 55 55 55 55 55 55 55 55 55 55 55 55 55 55 55 55 55 56 103 70 115 30 115 115 115 115 115 115 115 115 115 115 115 115 
115 115 115 115 115 115 115 115 103 54 55 55 55 55 55 55 55 55 55 55 55 55 55 55 55 55 55 55 55 55 55 55 55 56 103 115 101 115 27 28 28 28 28 28 28 28 28 28 28 28 
105 105 105 105 105 105 105 106 103 64 65 65 65 65 65 65 65 65 65 65 65 65 65 65 65 65 65 65 65 65 65 65 65 66 103 70 115 30 115 115 115 115 115 115 115 115 115 115 115 115 
125 125 125 125 125 125 125 126 103 115 115 115 115 115 115 115 115 115 115 115 115 115 43 43 73 115 115 115 115 115 115 115 115 115 103 115 103 115 103 103 103 103 103 103 103 103 103 103 103 103 
115 115 115 115 115 115 115 115 103 103 103 103 103 103 103 103 103 103 103 103 103 103 53 53 89 103 103 103 103 103 103 103 103 103 103 103 103 103 103 103 103 103 103 103 103 103 103 103 103 103 
103 103 103 103 103 103 103 103 103 103 103 103 103 103 103 103 103 103 103 103 103 103 89 53 83 103 103 103 103 103 103 103 103 103 103 103 103 103 103 103 103 103 103 103 103 103 103 103 103 103 
103 103 103 103 103 103 103 103 103 103 103 103 103 103 103 103 103 103 103 103 103 103 89 53 53 103 7 103 8 103 103 103 103 103 103 103 103 103 103 103 103 103 103 103 103 103 103 103 103 103 
103 103 103 103 103 103 103 103 103 103 103 103 103 103 103 103 103 103 103 74 75 76 53 53 53 103 105 103 105 103 103 103 103 103 103 103 103 103 103 103 103 103 103 103 103 103 103 103 103 103 
103 103 103 103 103 103 103 103 103 103 103 103 103 103 103 103 103 103 103 84 85 86 53 83 53 103 115 103 115 103 103 103 103 103 103 103 103 103 103 103 103 103 103 103 103 103 103 103 103 103 
103 103 103 103 103 103 103 103 103 103 103 103 103 103 103 103 103 103 103 94 95 96 83 53 53 103 17 103 88 103 103 103 103 103 103 103 103 103 103 103 103 103 103 103 103 103 103 103 103 103 
103 103 103 103 103 103 103 103 103 103 103 103 103 103 103 103 103 103 103 115 115 115 83 53 89 103 105 103 105 103 103 103 103 103 103 103 103 103 103 103 103 103 103 103 103 103 103 103 103 103 
103 103 103 103 103 103 103 103 103 103 103 103 103 103 103 103 103 103 103 103 103 103 89 53 83 103 115 103 115 103 103 103 103 103 103 103 103 103 103 103 103 103 103 103 103 103 103 103 103 103 
103 103 103 103 103 103 103 103 103 103 103 103 103 103 103 103 103 103 103 103 103 103 53 83 53 103 100 101 102 103 103 103 103 103 103 103 103 103 103 103 103 103 103 103 103 103 103 103 103 103 
103 103 103 103 103 103 103 103 103 103 103 103 103 103 103 103 103 103 103 103 103 103 93 93 93 103 115 115 115 103 103 103 103 103 103 103 103 103 103 103 103 103 103 103 103 103 103 103 103 103 
103 103 103 103 103 103 103 103 103 103 103 103 103 103 103 103 103 44 45 45 45 45 45 45 45 45 45 45 45 46 103 103 103 103 103 103 103 103 103 103 103 103 103 103 103 103 103 103 103 103 
103 103 103 103 103 103 103 103 103 103 103 103 103 103 103 103 103 54 55 55 55 55 55 55 55 55 55 55 85 86 103 103 103 103 103 103 103 103 103 103 103 103 103 103 103 103 103 103 103 103 
103 103 103 103 103 103 103 103 103 103 103 103 103 103 103 103 103 54 55 1 21 22 55 55 55 20 21 2 55 56 103 103 103 103 103 103 103 103 103 103 103 103 103 103 103 103 103 103 103 103 
103 103 103 103 103 103 103 103 103 103 103 103 103 103 103 103 103 54 55 13 35 36 55 55 55 34 35 13 55 56 103 103 103 103 103 103 103 103 103 103 103 103 103 103 103 103 103 103 103 103
103 103 103 103 103 103 103 103 103 103 103 103 103 103 103 103 103 54 55 23 55 55 55 55 55 55 131 23 55 56 103 103 103 103 103 44 45 45 45 45 46 103 103 103 103 103 103 103 103 103
103 103 103 103 103 103 103 103 103 103 103 103 103 103 103 103 103 84 85 10 55 55 55 55 55 55 55 10 55 56 103 103 103 103 103 54 104 105 105 106 56 27 28 28 28 28 28 28 28 28 
103 103 103 103 103 103 103 103 103 103 103 103 103 103 103 103 103 54 55 55 55 55 107 108 109 55 55 55 55 56 103 103 103 103 103 54 114 115 115 116 56 115 115 115 115 115 115 115 115 115 
103 103 103 0 103 0 103 30 103 103 103 103 103 103 103 103 103 54 55 55 55 55 117 118 119 55 55 55 55 56 103 103 103 103 103 54 124 125 125 126 56 27 28 28 28 28 28 28 28 28 
103 103 103 115 103 115 103 115 103 103 103 103 103 103 103 103 103 54 55 3 55 55 127 128 129 55 55 9 55 56 103 103 103 103 103 54 55 55 55 55 56 115 115 115 115 115 115 115 115 115 
103 103 103 73 103 73 103 73 103 103 103 103 103 103 103 103 103 54 55 13 55 55 55 55 55 55 55 13 55 56 103 103 103 103 103 54 55 55 55 55 56 27 28 28 28 28 28 28 28 28 
103 120 112 53 120 53 110 53 112 103 103 103 103 103 103 103 103 54 55 11 21 22 55 55 55 27 21 12 55 56 103 103 103 103 103 54 55 55 55 55 56 115 115 115 115 115 115 115 115 115
103 120 110 53 120 53 110 53 112 103 103 103 103 103 103 103 103 54 55 34 35 36 55 55 55 34 35 36 55 56 103 103 103 103 103 54 55 55 55 55 56 103 103 103 103 103 103 103 103 103 
103 102 100 53 102 53 102 53 102 103 103 103 103 103 103 103 103 64 65 65 65 65 65 65 65 65 65 65 65 96 103 103 103 103 103 64 65 65 65 65 66 103 103 103 103 103 103 103 103 103 
103 44 45 45 45 45 45 45 46 103 103 103 103 103 103 103 103 115 115 115 115 115 71 91 72 115 115 115 115 115 103 103 103 103 103 115 115 115 115 59 115 103 103 103 103 103 103 103 103 103 
103 54 55 55 55 55 55 55 56 103 103 103 103 103 103 103 103 103 103 103 103 0 53 115 53 0 103 103 103 103 103 112 103 112 103 103 103 103 103 59 103 103 103 103 103 103 103 103 103 103 
103 54 55 55 104 105 105 106 56 103 103 103 103 103 103 103 103 103 103 103 103 115 89 103 83 115 103 103 103 103 103 105 103 105 103 103 103 103 103 59 0 103 103 103 103 103 103 103 103 103 
103 54 55 55 114 115 115 116 56 100 103 103 103 103 103 9 103 103 103 103 103 103 53 103 83 103 103 103 103 103 103 115 103 115 103 103 103 103 103 59 115 103 103 103 103 103 103 103 103 103 
103 54 55 55 124 125 125 126 56 102 103 103 103 27 28 29 103 103 103 103 103 0 53 103 53 0 103 103 103 103 103 103 103 103 103 103 103 103 0 59 103 103 103 103 103 103 103 103 103 103 
103 54 55 55 55 55 55 55 56 115 0 103 103 115 115 115 103 103 103 103 103 115 53 103 53 115 103 103 103 103 103 103 103 103 103 103 103 0 115 89 0 103 103 103 103 103 103 103 103 103 
103 54 104 105 106 55 55 55 56 90 91 68 68 68 68 98 68 68 68 68 68 98 99 103 51 68 68 68 68 68 98 91 68 68 68 68 98 68 68 99 115 103 103 103 103 103 103 103 103 103 
100 54 114 115 116 55 55 55 56 115 0 115 115 115 115 115 115 115 115 115 115 0 115 103 115 0 115 115 115 115 115 115 115 115 115 0 115 115 0 115 0 103 103 103 103 103 103 103 103 103 
102 54 124 125 126 55 55 55 56 103 115 103 103 103 103 103 103 103 103 103 103 115 103 103 103 115 103 103 103 103 103 103 103 103 103 115 103 103 115 103 115 103 103 103 103 103 103 103 103 103 
115 64 65 65 65 65 65 65 66 103 103 103 103 103 103 103 103 103 103 103 103 103 103 103 103 103 103 103 103 103 103 103 103 103 103 103 103 103 103 103 103 103 103 103 103 103 103 103 103 103 
103 115 115 115 115 115 115 115 115 103 103 103 103 103 103 103 103 103 103 103 103 103 103 103 103 103 103 103 103 103 103 103 103 103 103 103 103 103 103 103 103 103 103 103 103 103 103 103 103 103 
103 103 103 103 103 103 103 103 103 103 103 103 103 103 103 103 103 103 103 103 103 103 103 103 103 103 103 103 103 103 103 103 103 103 103 103 103 103 103 103 103 103 103 103 103 103 103 103 103 103 
103 103 103 103 103 103 103 103 103 103 103 103 103 103 103 103 103 103 103 103 103 103 103 103 103 103 103 103 103 103 103 103 103 103 103 103 103 103 103 103 103 103 103 103 103 103 103 103 103 103 
103 103 103 103 103 103 103 103 103 103 103 103 103 103 103 103 103 103 103 103 103 103 103 103 103 103 103 103 103 103 103 103 103 103 103 103 103 103 103 103 103 103 103 103 103 103 103 103 103 103 
103 103 103 103 103 103 103 103 103 103 103 103 103 103 103 103 103 103 103 103 103 103 103 103 103 103 103 103 103 103 103 103 103 103 103 103 103 103 103 103 103 103 103 103 103 103 103 103 103 103 
