23 23 23 23 23 23 23 23 23 23 23 23 23 23 23 23 23 23 23 23 23 23 23 23 23 23 23 23 23 23
23 27 28 25 25 25 25 25 25 25 25 25 25 27 28 27 25 25 25 25 25 25 25 25 25 25 25 28 27 23
23 28 27 28 25 25 25 25 25 25 25 25 25 27 28 27 25 25 25 25 25 25 25 25 25 25 28 27 28 23
23 25 28 27 28 25 25 25 25 25 25 25 25 27 28 27 25 25 25 25 25 25 25 25 25 28 27 28 28 23
23 25 25 28 27 28 25 25 25 25 25 25 25 27 28 27 25 25 25 25 25 25 25 25 28 27 28 28 28 23
23 25 25 25 28 27 28 25 25 25 25 25 25 27 28 27 25 25 25 25 25 25 25 28 27 28 28 27 28 23
23 25 25 25 25 28 27 28 25 25 25 25 25 27 28 27 25 25 25 25 25 25 28 27 28 28 28 28 27 23
23 25 25 25 25 25 28 27 28 25 25 25 25 27 28 27 25 25 25 25 25 28 27 28 28 28 28 28 27 23
23 25 25 25 25 25 25 28 27 28 25 25 25 27 28 27 25 25 25 25 28 27 28 28 25 28 28 28 28 23
23 25 25 25 25 25 25 25 28 27 28 28 25 27 28 27 25 25 25 28 27 28 28 28 28 28 28 28 27 23
23 25 25 25 25 25 25 25 25 28 27 28 25 27 28 27 25 25 28 27 28 28 25 25 25 28 28 28 28 23
23 25 25 25 25 25 25 25 25 25 28 27 28 27 28 27 25 28 27 28 28 25 25 28 28 28 28 28 27 23
23 25 25 25 25 25 25 25 25 25 25 28 27 27 28 27 28 27 28 28 28 25 25 25 25 28 28 28 28 23
23 27 27 27 27 27 27 27 27 27 27 27 27 27 28 27 27 27 27 27 27 27 27 27 27 27 27 27 27 23
23 28 28 28 28 28 28 28 28 28 28 28 28 27 30 27 28 28 28 28 28 28 28 28 28 28 28 28 28 23
23 27 27 27 27 27 27 27 27 27 27 27 27 27 28 27 27 27 27 27 27 27 27 27 27 27 27 27 27 23
23 25 25 25 25 25 25 25 25 25 25 25 28 27 28 27 27 28 25 25 28 25 25 25 25 28 28 28 28 23
23 25 25 25 25 25 25 25 25 25 25 28 27 27 28 27 28 27 28 25 25 25 25 28 28 28 28 28 27 23
23 25 25 25 25 25 25 25 25 25 28 27 25 27 28 27 28 28 27 28 28 25 25 25 25 28 28 28 28 23
23 25 25 25 25 25 25 25 25 29 27 28 28 27 28 27 27 28 28 27 28 25 25 28 28 28 28 28 27 23
23 25 25 25 25 25 25 25 28 27 25 28 25 27 28 27 25 25 25 28 27 28 25 25 25 28 28 28 28 23
23 25 25 25 25 25 25 28 27 25 28 25 28 27 28 27 25 25 28 25 28 27 28 25 28 28 28 28 28 23
23 25 25 25 25 25 28 27 25 28 25 25 25 27 28 27 25 25 25 25 28 28 27 28 25 28 28 28 28 23
23 25 25 25 25 28 27 27 28 25 25 25 25 27 28 27 25 25 25 25 25 25 28 27 28 28 28 28 27 23
23 25 25 25 28 27 28 28 25 25 25 25 25 27 28 27 25 25 25 25 25 25 25 28 27 28 28 28 27 23
23 25 25 28 27 27 28 25 25 25 25 25 25 27 28 27 25 25 25 25 25 25 25 28 28 27 28 28 27 23
23 25 28 27 28 25 25 25 25 25 25 25 25 27 28 27 25 25 25 25 25 25 25 28 28 28 27 28 27 23
23 28 27 25 25 25 25 25 25 25 25 25 25 27 28 27 25 25 25 25 25 25 25 28 28 28 28 27 28 23
23 27 28 25 25 25 25 25 25 25 25 25 25 27 28 27 25 25 25 25 25 25 25 28 28 28 28 28 27 23
23 23 23 23 23 23 23 23 23 23 23 23 23 23 23 23 23 23 23 23 23 23 23 23 23 23 23 23 23 23

